1111111111
1100000001
1000000001
1000000001
1112211111
1000000011
1111111111