1111111111
1000000001
1000000001
1111101111
1000000001
1100000001
1111111111