1111111111
1000000001
1000000001
1111121111
1000000001
1100002001
1111111111